0,0,0,0,0,0,0,0,0
0,0,546,0,0,0,0,0,0
0,546,91,36,0,0,0,0,0
196,15,175,85,316,190,540,0,0
175,106,190,106,141,546,0,0,0
546,21,0,175,15,21,0,0,0
175,141,196,190,190,211,960,0,0
0,175,15,700,190,15,0,0,0
0,0,0,0,0,0,0,0,0

